MMMMMMMMMMMMMMMMMMMMMMMMMMMMMMMMMMMMMMMMMMMMMMMMMMMMMMMMMMMM
MMMMMMMMMMMMMMMMMMMMMMMMMMMMMMMMMMMMMMMMMMMMMMMMMMMMMMMMMMMM
MM........................................................MM
MM........................................................MM
MM........................................................MM
MM........................................................MM
MM........................................................MM
MM........................................................MM
MM........MM....................................MM........MM
MM........MM....................................MM........MM
MM........MM....................................MM........MM
MM........MM....................................MM........MM
MM........MM....................................MM........MM
MM........MM....................................MM........MM
MM........MM....................................MM........MM
MM........MM....................................MM........MM
MM........MM....................................MM........MM
MM........MM....................................MM........MM
MM........MMMMMMMMMMMMMMMMMMMMMMMMMMMMMMMMMMMMMMMM........MM
MM........MMMMMMMMMMMMMMMMMMMMMMMMMMMMMMMMMMMMMMMM........MM
MM........MM....................................MM........MM
MM........MM....................................MM........MM
MM........MM....................................MM........MM
MM........MM....................................MM........MM
MM........MM....................................MM........MM
MM........MM....................................MM........MM
MM........MM....................................MM........MM
MM........MM....................................MM........MM
MM........................................................MM
MM........................................................MM
MM........................................................MM
MM........................................................MM
MM........................................................MM
MM........................................................MM
MMMMMMMMMMMMMMMMMMMMMMMMMMMMMMMMMMMMMMMMMMMMMMMMMMMMMMMMMMMM
MMMMMMMMMMMMMMMMMMMMMMMMMMMMMMMMMMMMMMMMMMMMMMMMMMMMMMMMMMMM
7,7