MMMMMMMMMMMMMMMMMMMMMMMMMMMMMMMMMMMMMMMMMMMMMMMMMMMMMMMMMMMM
MMMMMMMMMMMMMMMMMMMMMMMMMMMMMMMMMMMMMMMMMMMMMMMMMMMMMMMMMMMM
MMMMMMMMMMMMMMMMMMMMMMMMMMMMMM............................MM
MMMMMMMMMMMMMMMMMMMMMMMMMMMMMM............................MM
MMMMMMMMMMMMMMMMMMMMMMMMMMMMMM............................MM
MMMMMMMMMMMMMMMMMMMMMMMMMMMMMM............................MM
MMMMMMMMMMMMMMMMMMMMMMMMMMMMMM............................MM
MMMMMMMMMMMMMMMMMMMMMMMMMMMMMM............................MM
MMMMMMMMMMMMMMMMMMMMMMMMMMMMMM............................MM
MMMMMMMMMMMMMMMMMMMMMMMMMMMMMM............................MM
MMMMMMMMMMMMMMMMMMMMMM....................................MM
MMMMMMMMMMMMMMMMMMMMMM....................................MM
MMMMMMMMMMMMMMMMMMMMMM....................................MM
MMMMMMMMMMMMMMMMMMMMMM....................................MM
MMMMMMMMMMMMMMMMMMMMMM....................................MM
MMMMMMMMMMMMMMMMMMMMMM....................................MM
MMMMMMMMMMMMMMMMMMMMMM....................................MM
MMMMMMMMMMMMMMMMMMMMMM....................................MM
MM....................................MMMMMMMMMMMMMMMMMMMMMM
MM....................................MMMMMMMMMMMMMMMMMMMMMM
MM....................................MMMMMMMMMMMMMMMMMMMMMM
MM....................................MMMMMMMMMMMMMMMMMMMMMM
MM....................................MMMMMMMMMMMMMMMMMMMMMM
MM....................................MMMMMMMMMMMMMMMMMMMMMM
MM....................................MMMMMMMMMMMMMMMMMMMMMM
MM....................................MMMMMMMMMMMMMMMMMMMMMM
MM............................MMMMMMMMMMMMMMMMMMMMMMMMMMMMMM
MM............................MMMMMMMMMMMMMMMMMMMMMMMMMMMMMM
MM............................MMMMMMMMMMMMMMMMMMMMMMMMMMMMMM
MM............................MMMMMMMMMMMMMMMMMMMMMMMMMMMMMM
MM............................MMMMMMMMMMMMMMMMMMMMMMMMMMMMMM
MM............................MMMMMMMMMMMMMMMMMMMMMMMMMMMMMM
MM............................MMMMMMMMMMMMMMMMMMMMMMMMMMMMMM
MM............................MMMMMMMMMMMMMMMMMMMMMMMMMMMMMM
MMMMMMMMMMMMMMMMMMMMMMMMMMMMMMMMMMMMMMMMMMMMMMMMMMMMMMMMMMMM
MMMMMMMMMMMMMMMMMMMMMMMMMMMMMMMMMMMMMMMMMMMMMMMMMMMMMMMMMMMM
16,3
