MMMMMMMMMMMMMMMMMMMMMMMMMMMMMMMMMMMMMMMMMMMMMMMMMMMMMMMMMMMM
MMMMMMMMMMMMMMMMMMMMMMMMMMMMMMMMMMMMMMMMMMMMMMMMMMMMMMMMMMMM
MM..........................MM............................MM
MM..........................MM............................MM
MM........................................................MM
MM........................................................MM
MM..........................MM............................MM
MM..........................MM............................MM
MM........................................................MM
MM........................................................MM
MM..........................MM............................MM
MM..........................MM............................MM
MM........................................................MM
MM........................................................MM
MM..........................MM............................MM
MM..........................MM............................MM
MM........................................................MM
MM........................................................MM
MM..........................MM............................MM
MM..........................MM............................MM
MM........................................................MM
MM........................................................MM
MM..........................MM............................MM
MM..........................MM............................MM
MM........................................................MM
MM........................................................MM
MM..........................MM............................MM
MM..........................MM............................MM
MM........................................................MM
MM........................................................MM
MM..........................MM............................MM
MM..........................MM............................MM
MM........................................................MM
MM........................................................MM
MMMMMMMMMMMMMMMMMMMMMMMMMMMMMMMMMMMMMMMMMMMMMMMMMMMMMMMMMMMM
MMMMMMMMMMMMMMMMMMMMMMMMMMMMMMMMMMMMMMMMMMMMMMMMMMMMMMMMMMMM
4,5