MMMMMMMMMMMMMMMMMMMMMMMMMMMMMMMMMMMMMMMMMMMMMMMMMMMMMMMMMMMM
MMMMMMMMMMMMMMMMMMMMMMMMMMMMMMMMMMMMMMMMMMMMMMMMMMMMMMMMMMMM
MM........................................................MM
MM........................................................MM
MM........................................................MM
MM........................................................MM
MM........................................................MM
MM........................................................MM
MM........................................................MM
MM........................................................MM
MM..............MMMMMMMMMMMM......MMMMMMMMMM..............MM
MM..............MMMMMMMMMMMM......MMMMMMMMMM..............MM
MM..............MM........................MM..............MM
MM..............MM........................MM..............MM
MM..............MM........................MM..............MM
MM..............MM........................MM..............MM
MM........................................................MM
MM........................................................MM
MM........................................................MM
MM........................................................MM
MM..............MM........................MM..............MM
MM..............MM........................MM..............MM
MM..............MM........................MM..............MM
MM..............MM........................MM..............MM
MM..............MMMMMMMMMMMM......MMMMMMMMMM..............MM
MM..............MMMMMMMMMMMM......MMMMMMMMMM..............MM
MM........................................................MM
MM........................................................MM
MM........................................................MM
MM........................................................MM
MM........................................................MM
MM........................................................MM
MM........................................................MM
MM........................................................MM
MMMMMMMMMMMMMMMMMMMMMMMMMMMMMMMMMMMMMMMMMMMMMMMMMMMMMMMMMMMM
MMMMMMMMMMMMMMMMMMMMMMMMMMMMMMMMMMMMMMMMMMMMMMMMMMMMMMMMMMMM
10,8
