MMMMMMMMMMMMMMMMMMMMMMMMMMMMMMMMMMMMMMMMMMMMMMMMMMMMMMMMMMMM
MMMMMMMMMMMMMMMMMMMMMMMMMMMMMMMMMMMMMMMMMMMMMMMMMMMMMMMMMMMM
MM........................................................MM
MM........................................................MM
MM........................................................MM
MM........................................................MM
MM........................................................MM
MM........................................................MM
MM........................................................MM
MM........................................................MM
MM..........MMMMMMMMMMMMMMMMMMMMMMMMMMMMMMMMMMMM..........MM
MM..........MMMMMMMMMMMMMMMMMMMMMMMMMMMMMMMMMMMM..........MM
MM........................................................MM
MM........................................................MM
MM........................................................MM
MM........................................................MM
MM........................................................MM
MM........................................................MM
MM........................................................MM
MM........................................................MM
MM........................................................MM
MM........................................................MM
MM........................................................MM
MM........................................................MM
MM..........MMMMMMMMMMMMMMMMMMMMMMMMMMMMMMMMMMMM..........MM
MM..........MMMMMMMMMMMMMMMMMMMMMMMMMMMMMMMMMMMM..........MM
MM........................................................MM
MM........................................................MM
MM........................................................MM
MM........................................................MM
MM........................................................MM
MM........................................................MM
MM........................................................MM
MM........................................................MM
MMMMMMMMMMMMMMMMMMMMMMMMMMMMMMMMMMMMMMMMMMMMMMMMMMMMMMMMMMMM
MMMMMMMMMMMMMMMMMMMMMMMMMMMMMMMMMMMMMMMMMMMMMMMMMMMMMMMMMMMM
9,7